┌──┬──────────┬────────┬──┐
S  │          │        │  │
│  │  ──┬──┐  ├─────┐  │  │
│  │    │  │  │     │     │
│  └─┐  │  │  │  │  │  │  │
│    │     │  │  │     │  │
├──  ├─────┘  └──┼─────┘  │
│    │           │        │
│  ──┘  ┌────┐   ├─────┐  │
│       │    │   │     │  │
│  ─────┴──  │   │  │  │  │
│            │      │     F
└─────────────────────────┘
