+-+-+-+-+-+-+-+-+-+
S |       |     | |
+ + +-+-+ +-+-+ + +
| |   | | |   |   |
+ +-+ + + + + + + +
|   |   | | |   | |
+-+ +-+-+ +-+-+-+ +
|   |       |     |
+ +-+ +-+-+ +-+-+ +
|     |   | |   | |
+ +-+-+-+ + + + + +
|         |   |   F
+-+-+-+-+-+-+-+-+-+
