┌─┬───────┬─────┬─┐
S │       │     │ │
│ │ ──┬─┐ ├───┐ │ │
│ │   │ │ │   │   │
│ └─┐ │ │ │ │ │ │ │
│   │   │ │ │   │ │
├── ├───┘ └─┼───┘ │
│   │       │     │
│ ──┘ ┌───┐ ├───┐ │
│     │   │ │   │ │
│ ────┴── │ │ │ │ │
│         │   │   F
└─────────────────┘
