+-+-+-+-+-+-+-+-+-+-+-+-+-+-+-+-+
S   |       |     |   |   |     |
+-+ + +-+-+ +-+ +-+ + + + + +-+ +
|   |   |           |   | |   | |
+ +-+-+ + +-+-+ +-+-+-+-+ +-+-+ +
|     | |   | | |       | |     |
+-+-+ + +-+ + + + + + +-+ + +-+-+
|     | | | | | | | |   |       |
+ +-+-+ + + + + +-+ +-+ +-+-+-+ +
| |     | | | |   |   | |       |
+ + +-+-+ + + +-+ +-+ + + +-+-+-+
| |       | |   | | | | |   |   |
+ +-+-+-+-+ + +-+ + + +-+-+ + + +
|           | |   | |         | |
+-+ + +-+-+-+ + +-+ +-+-+-+ +-+ +
|   | |   | |   |       |   | | |
+ +-+ +-+ + +-+-+ +-+-+ +-+ + + +
|   |     |     | |   |     |   |
+ +-+-+-+-+-+-+ + + + +-+-+-+ +-+
| |   |   |   |   | |         | |
+ + + + + + + +-+-+ +-+-+-+-+-+ +
| | |   | | |   |   |           |
+ + +-+-+ + +-+-+ +-+ +-+ +-+ +-+
|   |     |           |   |     F
+-+-+-+-+-+-+-+-+-+-+-+-+-+-+-+-+
