+-+-+-+-+-+-+-+-+-+-+-+-+-+-+-+-+-+-+-+-+-+-+-+-+
S       |     |           |         |           |
+ +-+-+ +-+-+ + +-+-+-+-+ + +-+-+-+ + +-+-+ +-+ +
| |     |   | | |   | |   | |       | |   | |   |
+-+ +-+-+ + + + +-+ + + +-+ + +-+-+-+ + + + + +-+
|   |     | | |   |   | |   |   |   | | | | |   |
+ +-+-+-+-+ + + + +-+ + + +-+-+ + + + + + + +-+ +
|   |       | | |   |     | |     | |   | | |   |
+-+ + +-+ +-+ +-+ + +-+ +-+ + +-+-+ +-+ + + +-+-+
|     | |     |   | |   | |   |   | |   | |   | |
+ +-+-+ +-+-+-+ +-+-+ +-+ + + +-+ + +-+-+ +-+ + +
| |     |   |   |     | |   |   | |     | |   | |
+ + +-+-+ + + +-+ +-+-+ +-+-+-+ + +-+-+ + +-+ + +
| |   |   |   |         |     | | |     |   | | |
+ +-+ + + +-+-+ +-+-+-+-+-+ +-+ + + +-+-+-+ +-+ +
|       |   |   |       |   |   | |         |   |
+-+-+ +-+-+ + +-+ + +-+ + +-+ +-+ +-+-+ + +-+ +-+
|     |     | |   |   |   |     |   |   |     | |
+ +-+-+-+-+-+ + + +-+ +-+-+ + + +-+ + +-+-+-+-+ +
|   |       |   | |   |     | |     | |     | | |
+-+ + +-+-+ +-+-+-+ +-+ +-+-+ +-+-+-+-+ +-+ + + +
|   | |   | |   |   |   |   |   |       |   |   |
+ +-+-+ + + + + + +-+ +-+ + +-+ +-+ +-+-+ + + + +
|       |   | |   |       |   |     |     |   | F
+-+-+-+-+-+-+-+-+-+-+-+-+-+-+-+-+-+-+-+-+-+-+-+-+
